PORTALS: (7,0)->(12,3)
S....<<P........#.#.
.....#..........#.#.
.....#..........#.#.
....##......P<......
>####.......<<.#...#
>##.............###.
...............>....
.<..................
...>.........<......
.............>......
...........<........
....<......>........
....................
....>...>...........
.............####...
....<.....####..###.
..........#.......##
.......>......<.....
...........>..<<<...
..............<<<..E
